.................
.................
.............#...
.p.....e..e......
############...##
...........#...#.
...........#...#.